211111111111331211111121
311121111111112131111111
111221111131111111111111
113111121311311111111111
132111211111112121111111
111311111111111311111111
111312111112121111121111
211112111112111121111111
111112112112111211112121
113111111113111111111111
311113111111131111113211
111131311111111111213111
112111113111111132111111
111111111111111111111122
111111111131112112111111
121311111111311111211111
131311132111111111112311
112222111111113112111112
112112112111111231111112
211111111121112312111111
213111121311111111111111
121213111112121111311111
111121311111111111111111
111212113111111111111121
111111111111111111111111
121111111111221111112111
111311111111121111111213
111311313311312311211111
111111111311231321131121
321211222111111111111121
121111112111112131111111
111211112211111311112111
211111212111111122112121
