111211111111111111112111
111111211331112121122111
111111111121111111111111
331111111211111112113111
121111311111211112212111
112311111112113132121112
112111111211111121121112
133111131221211211311121
111121311111111111121211
313111111121111111111111
123112111213111111111111
132111312111312112321112
311111121111111111113211
111112111111111212111111
111131111111111111111111
111131111121112211213111
111121111121113111111132
112111113111111113111121
111111111111111111111111
313111131111131211111112
112111111121111111111111
111131123111111311111122
111212211211111111111111
112111111111211112311111
112111111131111111121121
311111111311111111111121
111121111112211111111211
211311121121211211111111
111111121123131121111111
112211131111111311111121
111111211122111113211113
311111111113111113111111
111111111112211121111111
