111111111111111111112211
111111111112112121211111
121111111111111122121211
112111111121111111211211
111111111112122111211112
111211111112112111111111
111112211111121121111111
111111121111211111111111
112111111111311111111111
111111111111111211111111
121211111121112111111111
111111111112111121121112
211111111111111211111111
111121111111111121121112
111111111111111111111111
121111111111111111121221
111221111121111112112211
111111211211111111112111
111111211121111111111212
111111111211121111111211
111111111111111211111111
111212211211112111111121
111112111111111111111111
211112111112111111111112
111111111121121111111112
111111111121121122112111
111212112121111121111112
112111112112111111112111
111111111121111111111111
111111111211112111211111
111221111211111111111211
112211111111111121111111
111211111211121111112111
