132211121111111131111111
112111112121213111111111
111111211211111112121122
113311211111111111211111
311111112212112111113111
112111211112211111111311
131111211121113111111211
111112211111111111132111
111121111111111111132311
111111111113111111111111
111131113111131111121322
131112331111211111111111
113111111111112111111111
111111111111111311111111
111131111111211111111111
111112111111111131111122
112111111312211111221111
111121121211111111111112
211211111111111111111111
111231111111121131112111
111111111111111111121121
211111111111111111111131
111212211111111131211111
113112213111221111111111
121111111212211111111211
111111123211131123112111
111112111111311112111123
111121211221111111111311
111111111111111211121211
111111111213111112212311
111213113111131111112131
311111111121112111111111
111112111211111111111112
