121112221331111111131111
113111311111211111131111
112211231111111111211111
111111121111111112111111
111121121111111111111111
111121113122111211122111
111312111111112111111111
221112113231111113212111
111122131332111233211121
211121111111122311211211
131113133111111111111111
111111121221131122112111
111111211113111111111111
212221321132111111111111
111111111313111111111321
111111311113311111113111
111111121121111111112131
111111111211111131111111
113131212112311111211111
211211321111111111211132
311221111211111121321211
122111321111131111111321
111112111111121111111211
111121111231111111111112
111111111111111111121112
111112111113311211232111
111211121121111112323111
111111121111111113111111
111111112111111121111311
112111111111112122211313
121112322121111123211111
111131111112111111311111
121111121112112111121232
