111111111111312111211111
112111211121111111211111
111111112121211111111111
311111111111111111211111
111111111111111111111311
211111111111111121111111
111111111111211111111311
112111123111111111111311
111111121111111111121211
112111211111111312112111
121111221123111113113121
111111121123132121123111
111311111311111111111113
111111111111111113112111
111111111121111111211111
123222111132111113111211
111113123111111111211211
212121111111111111121111
113112113311112111311111
111113121112211111212111
121111111131121122111111
111111111111211112111121
111111111113211213112112
311111111131111131112111
121111112111211121113111
111311111111211111111111
111111111112312111111111
111211211111212213131111
111111111111111111113111
121111111111231111121111
111111121112113112211111
111111111111323211112211
112113121111111111112111
