211113112112111113131111
121121111111111123111111
211111111311111111111111
111111111211111133111111
211111111111111213111211
113121112111111111321111
211111111111211111111111
111112111121111211211111
111111211111122121311112
131112211111111131311113
111111111211121111111211
221113111121111131211121
111111111111111111121132
221311212111323112111321
221112112111111331222111
111111331111111122111111
111111111121111231111211
111311112211111111221111
121111131111111111122111
131112311111131221231211
111111111111111112112111
111112111111312112131111
221111111111111111111111
131211111211112111111111
112132111111111112112211
111211321111111121212111
111111111212111221111111
113211111111111321111111
212113111111111111111131
311111111112311113321121
211111111121112312312123
131131121212331211111322
333211111211111131111112
